######
#    #
#  ??#
#    #
######
