########
#    # #
#  ??#?#
#    # #
########
